111110011111
100000000001
101001000001
100000000001
000000100000
100000000001
100100000101
100000000001
111110011111