111110011111
100000000001
100000000001
100000000001
000000000000
100000000001
100000000001
100000000001
111110011111